14 12
200 200

3 3 3 3 3 3 3 4 5 3 3 1 3 3
3 3 3 3 3 4 5 6 7 4 5 1 3 3
3 3 3 3 3 6 7 1 0 6 7 1 3 3
1 1 1 1 1 1 1 1 1 1 1 1 8 8
3 3 3 4 5 8 4 5 1 4 5 8 8 8
3 3 3 6 7 8 6 7 1 6 7 3 3 3
3 3 3 8 8 1 1 1 1 1 1 1 1 1
3 3 3 8 8 1 3 3 1 8 8 8 8 8
3 3 3 3 8 1 3 3 1 1 1 1 1 1
8 3 9 3 3 1 3 3 9 1 4 5 3 3
8 3 3 3 3 1 3 3 3 1 6 7 3 3
8 3 3 3 3 1 3 3 3 1 3 3 3 3